NO./textures/rdr2.png
SO  ./textures/rdr22.png
WE               ./textures/highres.png
EA      ./textures/wood.png
DO               ./textures/highres.png
NP      ./textures/dice.png

C   0,0,255
F 0,255,0

            1111111111111111111111111
            1000000000110000000000001             
            1011000001110000000000001
            1001000000000000000000001           
    111111111011000001110000000000001
    100000000011000001110111112111111            
    11110111111111011100000010001
    11110111111111011101010010N01
    11000000110101011100000010001
    10000000000000001100000013031
    10000000000000001101010010301
    1100000111010101111101111000111
    11110111 1110101 101111010001
    11111111 1111111 111100000001
            1111111111111000000011111
            1000000000110000000000001             
            1011000001110000000000001
            1001000000000000000000001           
    111111111011000001110000000000001
    100000000011000001110111112111111            
    11110111111111011100000010001
    11110111111111011101010010001
    11000000110101011100000010001
    10000000000000001100000010001
    10000000000000001101010010001
    1100000111010101111101111000111
    11110111 1110101 101111010001
    11111111 1111111 111100000001
            1111111111111000000011111
            1000000000110000000000001             
            1011000001110000000000001
            1001000000000000000000001           
    111111111011000001110000000000001
    100000000011000001110111112111111            
    11110111111111011100000010001
    11110111111111011101010010001
    11000000110101011100000010001
    10000000000000001100000010001
    10000000000000001101010010001
    11000001110101011111011110001
    11111111111111111111111112111