NO ./textures/wall2.png
SO ./textures/wall.png
WE ./textures/wall2.png
EA ./textures/wall.png
DO ./textures/door.png
BG ./textures/background.png
MM ./textures/minimap.png
E1 ./textures/coin1.png
E2 ./textures/coin2.png
E3 ./textures/coin3.png
E4 ./textures/coin4.png
E5 ./textures/coin5.png
E6 ./textures/coin6.png
E7 ./textures/coin7.png
E8 ./textures/coin8.png
B1 ./textures/button1.png
B2 ./textures/button2.png
B3 ./textures/button3.png
B4 ./textures/button4.png

C 0,200,255
F 100,100,100

111111111111111111111111111111111
1000W0100000001000000010000000001
111110111110101010101011111110121
100000100010100010101010000310101
101110101010111110101010111011101
101000101010000010100000100010001
101011101011111010111111101110111
101003001000001010000010001000001
101111111111101111111010111011101
100000100000101000000010001000101
101111101011101011111111101111101
100000101003001010100000100000101
101110101111111010101010111110101
100010101000100010001010000310001
111010101010101010111010111111101
100010001010101010030010000000101
101110111010101010111011111010101
100010100000001010100000100010101
111010121111111010101111101111101
100010001020001010001000001000001
101111101011111010111011101211111
100000100010030010100010001010001
111110101110111110101110111010101
101000101000100000100000102010101
101011101011101111101111101110101
101000000010101010001000101000101
101111111110101010111010101111101
100000100000100010001010100010001
101110101111111011101010111010101
101000001000001010001010001000101
101111111011101010111010111111101
100000200000100010000010000000001
111111111111111111111111111111111
