NO ./textures/wall2.png
SO ./textures/wall.png
WE ./textures/wall2.png
EA ./textures/wall.png
DO ./textures/door.png
BG ./textures/background.png
MM ./textures/minimap.png
E1 ./textures/coin1.png
E2 ./textures/coin2.png
E3 ./textures/coin3.png
E4 ./textures/coin4.png
E5 ./textures/coin5.png
E6 ./textures/coin6.png
E7 ./textures/coin7.png
E8 ./textures/coin8.png
B1 ./textures/button1.png
B2 ./textures/button2.png
B3 ./textures/button3.png
B4 ./textures/button4.png

C 0,200,255
F 100,100,100

11111111111111111111111111111111111111111111111111111111111111111
10001000000000000000001000001000000000100000000000100000000000101
11101011111011111110101010111010111110111111101110101111101010101
10101000001000100000100010100010100000100010001000101000001010001
10101110101110101111111110101110101111101010111011101011101011101
10100010100010101000100010100000100000001000101000101000101000101
10111011101010101010101110101112111111111111101110101110101110101
10001000101010001010100000101000100000100000001010100000100010101
10101110101011111010111011101011101110111011101010101110101010101
10100010001000000010001000101010000010000010101010101000001010101
10111011101110111111101111101011111011111110101010101011111110111
10100000100010101000001000001000001010000000000310100010000010001
10101111111010101011111011111011101010101110111110111110101011101
10101000001010101000000010001010001000100010100010100010101000031
10101011101010101111111110101010111011111011121010101010101111101
101010000010100W1000000000101010001000001010001010201000100000001
10111011101010101011111110101011101111111010101011111110111111111
10100010001010101010000000100000001000001000101000000000100000001
10101110101010101010111111111011101011101110101111111111101111101
10100010101010001010001000000010001000000010000000001000001010001
10111010101010111011101010111110101011111010111110111011111010101
10100010101010001010001010000000101010000010100010100010000010101
10101110111011101010111011111111101010111110101010101112111110101
10100010100010001010001000100000001010001000101000001010000010101
10101110101111101111101110101111101011101011101111111010111010111
10101000100000100000100010001000101010001010001000100000102010001
10101011111110111110101011111010101010111110111011101111101111101
10101010000000100020101010000010130010100010000000001000100000101
10101010111110101111101010111010111110101010111011111010111010101
10001010100010100010001010101010000010001010001013000010000010101
10111010101010111010111010101011111011111011101110111111111110101
10101010201010100010001000101000101000101000100010001010000010101
10101011111010101111111011101110101110121110111010101010111010101
10001000001010101000001000001000100000102010001010101000101010101
10101110111010101011101111101011101111101111101011101011101010101
10100010000010000010001000001000101000001000100000001010001000101
10111011111111111110111111111110101110101010111111111010101111101
10001010000000001000000000000000100000101010001000000000100010001
10111010101111101111111110111111111110101011101010111111111010101
10100010100000100020100010100000000010100010001010000000100010101
10101110111110111110101010101111111010101110111011111110111110101
10100010100010100010001010100000001000101000100000000000000010101
10111011101010101011111010111111101111101011111110111111111010101
10001010001000101000101010000000101000001000000010000000100000101
10101010111111101010101010111111101011111111111010111110111111101
10101000130000001010001010000000001000000010031010100010000010001
10101111101111101011101011111011111111111011101011101011111010111
10100010000000001010001010001000000000001010001000101000100010001
10101010101110111010111010101011111111101010111110101110101011101
10001010100010001010001000101010001000001010100010001010001010001
10111010111011101011111111101010101111101010101011111011111010111
10100310100010001000000020100000100000101010001010000000000000101
10101110101111101110111110111111111110101010111010111011101111101
10101000100000100010101000000000101000101010100310001000001000001
10101011111110111010101011111110101010101010101111101111111111101
10101013100000101010001000000010001010101010100000100010000000001
10101010101111101011101111111010111010101011111110111011111011101
10001010130003101000101000000010100010001010000010001010001000101
11101010111110101110111011111111101111111010111210111010101110101
10001000001000100000100010000010001000000010000000100010100010101
10111111101011111110101110111010111010111110111111101110111010101
10000000001000100010001000100010100010001000100000100000101010101
10101111101110101011111011101110111111101010101110111111101010101
10100000000010001000000000000003000000001010000010000000000000101
11111111111111111111111111111111111111111111111111111111111111111
