NO ./textures/rdr2.png
SO ./textures/rdr22.png
WE ./textures/highres.png
EA ./textures/wood.png
DO ./textures/wb.png
NP ./textures/dice.png

F 20,100,0
C 225,30,0

1111111111111111111100
10000000000000000001
10000300000000000001
10000000100000000001
10000000010000020001
10000000001000000001
10000000000000000001
10000000000011001111
10000000000001001001
10003030000002002001
10000000000000000001
10000300000000000001
10000000100000000001
10000000010000020001
10E00000001000000001
10000000000000000001
10000000000011001111
10000000000001001001
10003030000002002001
11111111111111111111