NO ./textures/wall2.png
SO ./textures/wall.png
WE ./textures/wall2.png
EA ./textures/wall.png
DO ./textures/door.png
BG ./textures/background.png
MM ./textures/minimap.png
E1 ./textures/coin1.png
E2 ./textures/coin2.png
E3 ./textures/coin3.png
E4 ./textures/coin4.png
E5 ./textures/coin5.png
E6 ./textures/coin6.png
E7 ./textures/coin7.png
E8 ./textures/coin8.png
B1 ./textures/button1.png
B2 ./textures/button2.png
B3 ./textures/button3.png
B4 ./textures/button4.png

C 0,200,255
F 100,100,100

1111111111111111111111111111111111111111111111111111111111111111111111111111111111111111
1000000000000000000000000000000000000000000000000000000000000000000000000000000000000001
1000000000000000000000000000000000000000000000000000000000000000000000000000000000000001
1000000000000000000000000000000000000000000000000000000000000000000000000000000000000001
1000000000000000000000000000000000000000000000000000000000000000000000000000000000000001
1000000000000000000000000000000000000000000000000000000000000000000000000000000000000001
1000000000000000000000000000000000000000000000000000000000000000000000000000000000000001
1000000000000000000000000000000000000000000000000000000000000000000000000000000000000001
1000000000000000000000000000000000000000000000000000000000000000000000000000000000000001
1000000000000000000000000000000000000000000000000000000000000000000000000000000000000001
1000000000000000000000000000000000000000000000000000000000000000000000000000000000000001
1000000000000000000000000000000000000000000000000000000000000000000000000000000000000001
1000000000000000000000000000000000011111111111111111111100000000000000000000000000000001
1000000000000000000000000000000000010000300000200000000100000000000000000000000000000001
1000000000000000000000000000000000010003030001111111110100000000000000000000000000000001
1000000000000000000000000000000000010030303001002000000100000000000000000000000000000001
1000000000000000000000000000000000010000000001001111100100000000000000000000000000000001
1000000000000000000000000000000000010000N00001001000100000000000000000000000000000000001
1000000000000000000000000000000000010000000001001011100100000000000000000000000000000001
1000000000000000000000000000000000011111111111000000000100000000000000000000000000000001
1000000000000000000000000000000000000000000001011111211100000000000000000000000000000001
1000000000000000000000000000000000000000000001000000000000000000000000000000000000000001
1000000000000000000000000000000000000000000001110000000000000000000000000000000000000001
1000000000000000000000000000000000000000000000000000000000000000000000000000000000000001
1000000000000000000000000000000000000000000000000000000000000000000000000000000000000001
1000000000000000000000000000000000000000000000000000000000000000000000000000000000000001
1000000000000000000000000000000000000000000000000000000000000000000000000000000000000001
1000000000000000000000000000000000000000000000000000000000000000000000000000000000000001
1000000000000000000000000000000000000000000000000000000000000000000000000000000000000001
1000000000000000000000000000000000000000000000000000000000000000000000000000000000000001
1000000000000000000000000000000000000000000000000000000000000000000000000000000000000001
1111111111111111111111111111111111111111111111111111111111111111111111111111111111111111